+-+-+-+-+
##    |U|
+#+-+ +-+
|#| |   |
+#+ +-+-+
|#  |   |
+#+-+-+ +
|########
+-+-+-+-+
